Wo, Wo, Ww, Ww, Gs, Gs, Gs, Gs, Gs, Re, Re, Gs^Fds, Gs, Gs^Fds, Gs^Fds, Gs, Gg, Hh^Fds, Hh^Fds, Hh^Fds, Mm, Mm, Mm, Mm, Mm, Hh, Mm, Mm, Mm, Mm, Hh, Mm, Mm, Mm, Mm, Mm, Mm
Wo, Wo, Ww, Ww, Gd^Vo, Gs, Rb^Cov, Rb^Cov, Rb^Cov, Re, Re, Gs^Fds, Gs, Gs^Fds, Gs^Fds, Gs, Gd^Vo, Hh^Fds, Hh^Fds, Hh^Fds, Mm, Mm, Mm, Mm, Mm, Gd^Vo, Mm, Mm, Hh, Hh, Qxe, Hh, Hh, Mm, Mm, Mm, Mm
Ww, Ww, Gd^Vo, Gs, Gs, Mm, Rb^Cov, 5 Ker, Rb^Cov, Gs, Re, Gs, Gs^Fds, Gs^Fds, Mm, Mm, Mm, Mm, Mm, Hh^Fds, Mm, Mm, Ww, Mm, Mm, Mm, Mm, Mm, Hh, Gs^Dr, 1 Qxe, Gs^Dr, Hh, Mm, Mm, Mm, Mm
Gs, Gs, Gs^Fds, Gs^Fds, Gs, Mm, Gg, Rb^Cov, Gg, Gs, Re, Gs, Gd^Vo, Gs^Fds, Mm, Mm, Mm, Mm, Mm, Mm, Mm, Mm, Ww, Mm, Mm, Mm, Mm, Mm, Hh, Qxe, Gs^Dr, Qxe, Hh, Mm, Mm, Mm, Mm
Gs^Fds, Gs^Fds, Gs, Gs^Fds, Gs, Mm, Mm, Hh, Hh, Gs, Hh, Re, Hh, Gs, Mm, Mm, Mm, Mm, Mm, Mm, Mm, Ww, Ww, Gs, Gs, Mm, Hh, Hh, Hh, Hh, Hh, Hh, Ww, Ww, Mm, Mm, Mm
Gs^Fds, Gs^Fds, Mm, Gs, Gd^Vo, Gs, Mm, Mm, Mm, Hh, Hh, Re, Hh, Mm, Mm, Mm, Mm, Mm, Hh, Hh, Hh, Ww, Hh, Gd^Vo, Gs, Hh, Hh^Fds, Hh, Hh, Gs, Gd^Vo, Gs^Fds, Ww, Mm, Mm, Mm, Mm
Mm, Mm, Mm, Mm, Mm, Mm, Mm, Mm, Mm, Mm, Hh, Re, Hh, Mm, Mm, Mm, Mm, Hh, Hh, Hh, Hh^Fds, Ww, Hh^Fds, Hh^Fds, Gs^Fds, Gs^Fds, Gs^Fds, Hh^Fds, Gs^Fds, Gs, Ww, Ww, Hh^Fds, Mm, Mm, Mm, Mm
Mm, Mm, Mm, Mm, Mm, Mm, Mm, Mm, Mm, Hh, Hh, Re, Hh, Hh, Hh, Mm, Hh, Hh, Hh, Hh, Gs^Fds, Ww, Ww, Gg, Ww, Gs^Fds, Gs^Fds, Re, Gs^Fds, Ww, Gs^Fds, Hh^Fds, Hh^Fds, Mm, Mm, Mm, Mm
Mm^Xm, Mm^Xm, Mm^Xm, Mm, Mm, Mm, Mm, Mm, Mm, Mm, Hh, Re, Re, Hh, Mm, Mm, Hh, Hh^Fds, Hh^Fds, Hh^Fds, Gs^Fds, Gs^Fds, Ww, Ww, Ww, Gg, Gg, Gs^Fds, Ww, Ww, Gs^Fds, Gs^Fds, Hh^Fds, Hh^Fds, Hh^Fds, Mm, Mm
Mm^Xm, Mm^Xm, Mm^Xm, Mm^Xm, Mm, Mm, Mm, Mm, Mm, Hh^Fds, Hh, Hh, Re, Hh, Hh, Hh, Hh, Hh, Gs^Fds, Gs^Fds, Gs^Fds, Gs^Fds, Gd^Vo, Ww, Ww, Ww^Bw/, Ww, Ww, Ww^Bw/, Gg, Gg, Gs^Fds, Gs, Gs^Fds, Mm, Mm, Mm
Mm^Xm, Mm^Xm, Mm^Xm, Mm, Mm, Mm, Mm, Mm, Mm, Hh, Hh^Fds, Hh, Re, Hh, Gs, Gs, Gs, Gs, Rb^Cov, Gs^Fds, Gs^Fds, Gs^Fds, Ww^Bw\, Ww, Ww, Ww, Wo, Ww, Ww, Ww, Gs^Fds, Gs^Fds, Gs^Fds, Mm, Mm, Mm, Mm
Mm^Xm, Mm^Xm, Mm^Xm, Mm, Mm^Xm, Mm, Mm, Mm, Mm, Mm, Gs^Fds, Gs^Fds, Gs, Re, Re, Gg, Gg, Rb^Cov, 4 Ker, Rb^Cov, Ww, Ww, Wo, Ww, Wo, Wo, Wo, Ww, Ww^Bw\, Gg, Gs^Fds, Gs^Fds, Gs^Fds, Gs^Fds, Gg, Mm, Mm
Mm^Xm, Mm^Xm, Mm, Mm, Mm, Mm, Mm, Mm, Mm, Gs^Fds, Hh, Gs^Fds, Gs, Gg, Re, Gd^Vo, Gg, Rb^Cov, Rb^Cov, Rb^Cov, Ww, Ww, Wo, Wo, Wo, Wo, Wo, Ww, Ww, Gd^Vo, Gg, Gg, Gg, Gs^Fds, Gd^Vo, Mm, Mm
Mm^Xm, Mm^Xm, Mm, Mm, Mm, Mm, Mm, Mm, Mm, Mm, Mm, Hh, Hh^Fds, Gs, Gg, Re, Re, Gs, Gs^Fds, Gg, Ww^Bw\, Wo, Wo, Wo, Ww, Wo, Wo, Wo, Wo, Wo, Wo, Gg, Gg, Gg, Mm, Mm, Mm
Mm, Mm, Mm, Mm, Mm, Mm, Hh^Fds, Mm, Hh^Fds, Mm, Mm, Hh, Hh, Gs, Gg, Gg, Re, Gs, Gs^Fds, Ww, Wo, Wo, Ww, Ww, Gg, Ww, Wo, Gg, Rb^Cov, Gg, Gg, Gg, Gs^Fds, Gg, Mm, Mm, Mm
Mm, Mm, Mm, Mm, Mm, Hh^Fds, Gs^Fds, Gs^Fds, Gs^Fds, Mm, Hh, Hh, Hh, Gs, Gs, Gg, Re, Gs^Fds, Ww, Ww, Ww, Wo, Ww, Ww, Gg, Ww, Gg, Rb^Cov, 2 Ker, Rb^Cov, Gg, Gg, Gg, Gs^Fds, Gs, Mm, Mm
Mm, Mm, Mm, Mm, Hh^Fds, Hh^Fds, Gs^Fds, Gd^Vo, Ww, Gs^Fds, Ww, Hh, Hh, Hh, Gs, Gg, Gg, Re, Ww, Ww, Gg, Ww, Gd^Vo, Gs^Fds, Gg, Gg, Gg, Rb^Cov, Rb^Cov, Rb^Cov, Gs^Fds, Gs^Fds, Mm, Gs^Fds, Gd^Vo, Mm, Mm
Mm, Mm, Mm, Mm, Hh^Fds, Hh^Fds, Gs^Fds, Ww, Ww, Ss, Ww, Gs, Gs, Gs, Rb^Cov, Rb^Cov, Rb^Cov, Re, Gd^Vo, Ww, Gg, Gs^Fds, Gs^Fds, Gs^Fds, Gg, Gg, Rr, Rr, Gg, Gg, Gs, Mm, Mm, Mm, Mm, Mm, Mm
Mm, Mm, Mm, Mm, Hh^Fds, Hh^Fds, Gs^Fds, Ss, Gs^Fds, Ss, Ss, Gs^Fds, Gs, Hh, Rb^Cov, 3 Ker, Rb^Cov, Re, Gg, Ww, Gg, Gs^Fds, Gs^Fds, Gg, Rr, Rr, Gd^Vo, Re, Gg, Gg, Gd^Vo, Mm, Mm, Mm, Mm, Mm, Mm
Mm, Mm, Mm, Hh, Hh, Gd^Vo, Hh, Gs^Fds, Gs^Fds, Ss, Ww, Ss, Re, Gd^Vo, Re, Rb^Cov, Re, Re, Ww, Ww, Gg, Gg, Gg, Gg, Rr, Gg, Re, Re, Gg, Hh^Fds, Hh^Fds, Mm, Mm, Mm, Mm, Gs, Mm
Mm, Mm, Mm, Hh, Hh, Hh, Hh, Gs, Gs, Gs^Fds, Re, Ww^Bw/, Ww, Re, Ss, Re, Ss, Re, Ww^Bw\, Gg, Rr, Gg, Rr, Rr, Gg, Re, Gg, Gs^Fds, Gs^Fds, Hh^Fds, Hh^Fds, Mm, Mm, Mm, Mm, Mm, Mm
Mm, Mm, Mm, Mm, Mm, Hh, Hh, Hh, Re, Re, Hh, Gd^Vo, Ss, Ss, Ss, Ss, Ss, Ww, Gg, Rr, Gd^Vo, Rr, Gs, Gs, Gs, Gg, Gs^Fds, Gs^Fds, Mm, Hh^Fds, Mm, Hh^Fds, Mm, Mm, Mm, Mm, Mm
Mm, Mm, Mm, Mm, Hh, Hh, Hh, Re, Gs, Hh, Hh, Ww, Ww, Ww, Ss, Ss, Ss, Ss, Hh^Fds, Hh, Hh, Gs, Mm, Mm, Mm, Gs, Mm, Mm, Mm, Mm, Mm, Mm, Mm, Mm, Mm, Mm, Mm
Mm, Mm, Mm, Mm, Hh, Hh, Re, Re, Re, Gd^Vo, Hh, Hh, Hh, Ww, Gs, Gs, Mm, Gs^Fds, Gs^Fds, Hh^Fds, Hh, Mm, Mm, Mm, Mm, Mm, Mm, Mm, Mm, Mm, Mm, Mm, Mm, Mm, Mm, Mm, Mm
Mm, Mm, Mm, Hh, Hh, Re, Hh, Hh, Hh, Re, Hh, Mm, Mm, Hh, Mm, Gs, Mm, Gs^Fds, Mm, Mm, Mm, Mm, Mm, Mm, Mm, Mm, Mm, Mm, Mm, Mm, Gd^Vo, Mm, Mm, Mm, Mm, Mm, Mm
Mm, Mm, Mm, Mm, Mm, Hh, Mm, Mm, Hh, Re, Re, Hh, Mm, Mm, Mm, Mm, Mm, Mm, Mm, Mm, Mm, Mm, Mm, Mm, Mm, Mm, Mm, Mm, Mm, Mm, Mm, Gd^Vo, Mm, Mm, Mm, Mm, Mm
Mm, Mm, Mm, Mm, Mm, Mm, Mm, Mm, Hh, Re, Re, Hh, Mm, Mm, Mm, Mm, Mm, Mm, Mm, Mm, Mm, Mm, Mm, Mm, Mm, Mm, Mm, Mm, Mm, Mm, Mm, Mm, Mm, Mm, Mm, Mm, Mm
